1111111111111111111111111111111111
1C000000CCCC0000000000000000000001
1000000000000000000000000000000001
1000000111110000001111111000CC0001
1000000001100000000011100000000001
1000000001100000000110000000000001
1000000001100000011100000000CCCC01
10CC000000110000011000000000000001
1000000000110001110000111000000001
1000000000011110000001CE0000000001
10000CC00000101100000011100000CC01
1000000000001010000000000000000001
10000000000010100000000000CC000001
1000000000011010000000000000000001
1000000000011011000000000000000001
100000000001101000CC00000000000001
10000000000110000000000000C0000001
1000000000011000000000000000000001
1000CC0000011000000000000000000001
10000000000110000000CCCC0000P00001
1111111111111111111111111111111111