1111111111111111111111111111111111
1P00000000000000000000000000000001
1000000000000000000000000000000001
1000000111110000001111111000000001
1000000001100000000011100000000001
1000000001100000000110000000000001
1000000001100000011100000000000001
1000000000110000011000000000000001
1000000000110001110000111000000001
1000000000011110000001C00000000001
1000000000001000000000111000000001
1000000000001000000000000000000001
10000000000010000000000000E0000001
1000000000011000000000000000000001
1111111111111111111111111111111111