111111111111111111111111111111111111111111111111111111111111
1C000000CCCC000000000000000000000000000000000000000000000001
100000000000000000000000000000000000000000000000000000000001
1000000111110000001111111000CC000000000000000000000000000001
100000000110000000001110000000000000000000000000000000000001
100000000110000000011000000000000000000000000000000000000001
1000000001100000011100000000CCCC0000000000000000000000000001
10CC00000011000001100000000000000000000000000000000000000001
100000000011000111000011100000000000000000000000000000000001
1000000000011110000001CE000000000000000000000000000000000001
10000CC00000101100000011100000CC0000000000000000000000000001
100000000000101000000000000000000000000000000000000000000001
10000000000010100000000000CC00000000000000000000000000000001
100000000001101000000000000000000000000000000000000000000001
100000000001101100000000000000000000000000000000000000000001
100000000001101000CC0000000000000000000000000000000000000001
10000000000110000000000000C0P0000000000000000000000000000001
100000000001100000000000000000000000000000000000000000000001
1000CC000001100000000000000000000000000000000000000000000001
10000000000110000000CCCC000000000000000000000000000000000001
10000000000110000000CCCC000000000000000000000000000000000001
10000000000110000000CCCC000000000000000000000000000000000001
10000000000110000000CCCC000000000000000000000000000000000001
10000000000110000000CCCC000000000000000000000000000000000001
10000000000110000000CCCC000000000000000000000000000000000001
10000000000110000000CCCC000000000000000000000000000000000001
10000000000110000000CCCC000000000000000000000000000000000001
10000000000110000000CCCC000000000000000000000000000000000001
10000000000110000000CCCC000000000000000000000000000000000001
10000000000110000000CCCC000000000000000000000000000000000001
10000000000110000000CCCC000000000000000000000000000000000001
10000000000110000000CCCC000000000000000000000000000000000001
10000000000110000000CCCC000000000000000000000000000000000001
111111111111111111111111111111111111111111111111111111111111